####################
#..*....#..........#
#.......#....*.....#
##......#.........##
#.......#####......#
#..................#
#..........*.......#
#...?..*...........#
#......*...........#
#....#........#....#
######........######
#....#........#.....
#..................#
#......*.....*.....#
#..................#
##......#####..?..##
#.......*...#......#
#...........#......#
#...*.......#......#
####################